..........................
......@@......@@..........
......@@......@@..........
..##..@@......##..##..##..
..##..@@......##..##..##..
..##..........##..##@@##..
..##........####..##@@##..
......##..........@@......
......##..........@@......
%%....##....@@....##%%##@@
%%....##....@@....##%%##@@
%%%%......##....@@..%%....
%%%%......##....@@..%%....
..######%%%%%%@@....%%##..
..######%%%%%%@@....%%##..
......@@%%##..##..##..##..
......@@%%##..##..##..##..
@@##..@@..##..##......##..
@@##..@@..##..##......##..
..##..##..######..##..##..
..##..##..######..##..##..
..##..##..######..........
..##..##..................
..##..............##..##..
..##.......####...##..##..
..##..##...#..#...######..
..##..##...#..#...######..