..........................
...........#..#.%%%%......
...........#..#.%%%%......
..#..@..#........#%%#..#%%
..#..@..#........#%%#..#%%
..#..@..#...##...#%%#..#%%
..#..@..#...##...#%%#..#%%
..##....##..@@..##%%..##%%
..##....##..@@..##%%..##%%
.......#@@..##..##@...%%%%
.......#....##....@...%%%%
#####.....%%##%%.....#####
#####.....%%##%%.....#####
.........#%%%%%%#.........
.........#%%%%%%#.........
@@####..##%%%%%%##.#####@@
@@####....%%%%%%...#####@@
@@@@@@......%%......@@@@@@
........##..%%..##........
..##....##......##........
..##....##......##........
..###.....##..##.....###%%
..###................###%%
....##..............%%%%%%
...........####.....%%%%%%
...........#..#.......%%%%
....##.....#..#.....##%%%%