..........................
....##....##......##......
....##....##..##..##......
%%######..##......###.....
%%######..##..@@..###.....
%%%%%%....##..##..##...##.
%%%%%%........##.......##.
%%~~~~~~~~~~~~~~~~~~~~..~~
%%~~~~~~~~~~~~~~~~~~~~..~~
..##......................
..##........####..........
....##.....###########@@@@
....##.....#####..##......
####..##...#####%%##....##
####..##...#####%%##@@@@##
......@@......%%%%%%%%....
......@@..@@..%%%%%%%%....
~~~~..~~~~~~~~~~..~~~~~~~~
~~~~..~~~~~~~~~~..~~~~~~~~
%%%%...#..................
%%%%...#....####..........
%%%%##..#......#......##..
%%%%##..#......#..@@####..
%%..##..#.........##..##..
%%@@##..#..####.......##..
...........#..#.......##..
...........#..#...##......