..........................
..........................
........##......##........
..########......########..
..########......########..
..##........##........@@..
..##........##........@@..
..##..####......####..####
..##..##..........##..####
..##..#.%%..@@..%%.#..@@##
..##..#.%%@@@@@@%%.#..@@##
..##....%%%%%%%%%%....@@##
........%%%%%%%%%%......##
##......%%%%%%%%%%......##
##@@....%%%%%%%%%%....####
##@@..#.%%@@@@@@%%.#..##..
##@@..#.%%..@@..%%.#..##..
####..##..........##..@@..
####..####......####..@@..
##@@........##........##..
##@@........##........##..
##########......######@@@@
##########......######@@@@
####....##......##....##..
####.......####.......##..
####.......#..#...........
####.......#..#...........