..........................
..........................
.......##...........##....
..##..###.....------####..
..##..###.....------####..
..##....##..@@----------..
..##....##..@@----------..
------@.##....##--------..
------@.##....##--------..
------------####.##.......
------------####.##.......
.....@--------##.##...@@@@
.....@--------##.##.......
########--------------####
########--------------####
......####-------@........
......####-------@........
..######..------####..##..
..######..------####..##..
------##--........##..##..
------##--........##..##..
----------@@..@@......##..
----------..........####..
##--------........##......
##--------.####...##......
####@......#..#...##..##..
####@......#..#...##..##..