..........................
................@@@@@@%%..
................@@@@@@%%..
..##............@@....@@..
..##............@@....@@..
##%%##......########..@@..
##%%##......########..@@..
..##%%##....##..%%##@@@@..
..##%%##....##..%%##@@@@..
....##..%%@@##%%..##......
....##..%%@@##%%..##......
........@@..##@@####......
........@@..##@@####......
....####@@##..@@..........
....####@@##..@@..........
....##..%%##@@%%..........
....##..%%##@@%%..........
@@@@@@%%..##....####......
@@@@@@%%..##....####......
@@..########....##@@@@....
@@..########....##@@@@....
@@....@@..........@@####..
@@....@@..........@@####..
%%@@@@@@............##@@@@
%%@@@@@@...####.....##@@@@
...........#..#.......@@@@
...........#..#.......@@@@