..........................
@@@@@.......%%.......@@@@@
@@@.......%%%%%%.......@@@
@@@.....%%%%%%%%%%.....@@@
@.....##############.....@
@.....##############.....@
.....##............##.....
.....##............##.....
.....##@@@......@@@##.....
...##..@..........@..##...
...##..@..........@..##...
...##................##...
...##................##...
...##................##...
...##................##...
...##................##...
...##................##...
...##..@..........@..##...
.....##@..........@##.....
.%%....@@@......@@@....%%.
.%%....................%%.
...%%..############..%%...
@..%%..############..%%..@
@....%%............%%....@
@@@..%%....@@@@....%%..@@@
@@@........@..@........@@@
@@@@@......@..@......@@@@@