..........................
@@@@@.......%%.......@@@@@
@@@@......%%%%%%......@@@@
@@@.....%%%%%%%%%%.....@@@
@@....%%%%%%%%%%%%%%....@@
@........................@
.....##............##.....
.....##............##.....
.....##............##.....
..........................
..........................
..........................
..........................
..........................
..........................
..........................
..........................
..........................
..........................
.%%....................%%.
.%%....############....%%.
...%%..############..%%...
@..%%................%%..@
@@...%%............%%...@@
@@@..%%....@@@@....%%..@@@
@@@@.......@..@.......@@@@
@@@@@......@..@......@@@@@